111111
100001
100101
111111
111111
111111
111111
111111

