111111111
10000000B
11F111111
10E0020P1
100002001
100000001
1000M0001
100000001
10E000001
111110001
10Q0G0001
111111111